SO        ./cub.h       
NO        ./cub.h
EA        ./cub.h
WE        ./cub.h
F     1   ,    58 ,   12
C     111 ,   5   ,  2
11111
110N1
10001
11111         