SO        ./cub.h       
NO        ./cub.h
EA        ./cub.h
WE        ./cub.h
F  1, 251 ,255
C     111 ,   5   ,  2
11111
11011
1N001
11111         