SO        ./cub.h       
NO        ./cub.h
EA        ./cub.h
WE        ./cub.h
F     1   ,    58 ,   12
C     111 ,   5   ,  2

11111  111
     11111
   110000011
   100110001
   10000001
    111111   1111
111110011111
10000E000001
 1111100001
100000000001
111111111111