SO        ./cub.h       
NO        ./cub.h
EA        ./cub.h
WE        ./cub.h
F     1   ,    58 ,   12
C     111 ,   5   ,  2

     11111111111
   110000000000011
   100110001110001
   10000001   1001
11111001111111000011111
10000000000001000000001
10000000000100100100001
10000000000000001W10001
10000000000000000100001
11111111111111111111111