NO                ./cub.h   

SO                  ./cub.h

WE         ./cub.h

EA        ./cub.h

F  1,   2,  55                      

C      255 ,   5   ,   02

111111111111111111111111111   1
10000000001100000000000010111101
10110010111000000000000111101111
11001000000000000000000001111111111
1111011110110100011100000000000010S1
10000100001100000111011111111111111
11111111111111111111111111111111111
11111111111111111111111111111111101
111101111111110111000000100010111101
111101111111110111000100000011111111
111111111111111111111111111111111111
 
  
1111111111111111111111111111111111111
11000000110101011100000010001111111101
10000000010000001100000010001011111111
100000000000000011010100100011
1100000111010101111101111000111
1111111111111111111111111111111