    SO             ./cub.h         
NO        ./cub.h

   

    




EA        ./cub.h
WE        ./cub.h
F     1   ,    58 ,   12
C     111 ,   5   ,  2

11111  111
     11111
   110000011
   100110001
   10000001        1
111110011111
100000W00001
100000000001
111111111111
