SO        ./cub.h       
NO        ./cub.h
EA        ./cub.h
WE        ./cub.h
F     1   ,    58 ,   12
C     111 ,   5   ,  255


1                   1
    
     111111111
    1001000001
    11000000001
    100000N0001
    10010100101
     111111111
  
1                   1