SO        ./cub.h       
NO        ./cub.h
EA        ./cub.h
WE        ./cub.h
F     1   ,    58 ,   1   2
C     111 ,   5   ,  2 5 5


1                   1
    
     111111111
    1001000001
    1100000001
    10000000001
    100101N0101
     111111111
  
1                   1