    SO             ./cub.h         
NO        ./cub.h

   

    




EA        ./cub.h
WE        ./cub.h   
F     1     ,    58 ,   12
C     111 ,  5   ,  2   
WE        ./cub.h   









11111
111 1
11111   
1101
1001111  
11111      
 
 
   11
1   S1
 11111