SO        ./cub.h       
NO        ./cub.h
EA        ./cub.h
WE        ./cub.h
F     1   ,    58 ,   1   2
C     111 ,   5   ,  2 5 5


 1111111111
10010000001
11000N00001
10000000001
10010100101
 11111111111