NO                ./path_to_the_north_texture 
     
SO                  ./path_to_the_south_texture
       
WE ./path_to_the_west_texture 
       
EA ./path_to_the_east_texture

F 2,   100,,,,   0

C 225,   30  ,0




        

111111111111111111111111111                          
10000000001100000000000010111
1011001011100000000000011110111
11001000000000000000000001111101
111101111011010001110000000000001
10000N0000110000011101111111111111
11111111111111111111111111111111111
11111111111111111111111111111111101
111101111111110111000000100010111101
111101111111110111000100100011111111
111111111111111111111111111111111111
                                    
111111111111111111111111111111111111
110000001101010111000000100011111111
10000000000000001100000010001
10000000000000001101010010001
1100000111010101111101111000111
1111111111111111111111111111111