SO        ./cub.h       
NO        ./cub.h
EA        ./cub.h
WE        ./cub.h
F     1   ,    58 ,   1   2
C     111 ,   5   ,  2 5 5


   
   
1111111111  
1000000001  
10000N0001  
1000000001  
1111111111