NO                ./cub.h

SO                  ./cub.h

WE         ./cub.h

                 EA        ./cub.h                


F  1  ,   2  ,  255        

C      0 ,   5   ,   02

11111111111111111111111111111111111 
11111111111111111111111111111111111 
11111111111111111110N11111111111101
11111111111111111111111111111111111 
1111111111111111111111111111111111