SO        ./cub.h       
NO        ./cub.h
EA        ./cub.h
WE        ./cub.h
F     1   ,    58 ,   1   2
C     111 ,   5   ,  2 5 5
  1 1
 11111
1000001
1000001
1000001
100E001
1100001
1000001
 10101
  1 1