SO        ./cub.h       
NO        ./cub.h
EA        ./cub.h
WE        ./cub.h
F     1   ,    58 ,   1   2
C     111 ,   5   ,  2 5 5


 1111111111
10000101001
10001N10001
10000100001
10000000101
 11111111111