NO ./path_to_the_north_texture 
     
SO ./path_to_the_south_texture
WE ./path_to_the_west_texture 

EA ./path_to_the_east_texture

F 220,100,0
C 225,30,0



        


111111111111111111111111111111
 10000000000111000000000010000111111   
  11111101100000111000000000000111101
 11001000000000000000000001111111111
 111101111011000001110000000000001
  10000000001100000111011111111111
 11111111111111011111111111111   
 11111111111111011111111111111
 11110111111111011100000010001
 11110111111111011101100010001
 11000000110101011100000010001
 10000000001000001100000010001
 1000000000000000110N100010001
 1100000111111101111101111000111
 11111111 1110101    101111000001
 11111111 1111111     111111111111    