SO        ./cub.h       
NO        ./cub.h
EA        ./cub.h
WE        ./cub.h
F     1   ,    58 ,   1   2
C     111 ,   5   ,  2 5 5


1                                                    1
    
    111111111111111111111111111111111111111111111
   10010000010000011000000000000000000000000000001
   11000001111110001000000000000000000000001111001
   10000000001000100000000001000000000000000000001
   1001010010100000000000001N100000000000000000001
   10000000000000000001000001000000000000000000001
   10000100000000000011100000000000000000000000001
   10000000000000000001000000000000000000000000011
   11111100000001110000000000000000000000000001111
   10000001111000000000011111000000000000000000001
    111111111111111111111111111111111111111111111
    
1                                                    1