SO        ./texture/SO.xpm
NO        ./texture/NO.xpm
EA        ./texture/EA_2.xpm
WE        ./texture/WE_2.xpm

F     100 ,   130   ,  100
C     225, 230, 230


 11111111
1001000001
1000000001
1000000001
1000000001
1000000001
1000000001
1000000001
1000000001
1000000001
1000000001
1000000001
1000000001
1000000001
1000000001
1000000001
1000000001
1100001001
1000W001101
10010011101
 111111111