NO   ./texture/NO.xpm
SO   ./texture/SO.xpm
WE   ./texture/WE_2.xpm
EA   ./texture/EA_2.xpm


F   75, 100 , 110
C   225, 230, 230


1                                                    1
    
    111111111111111111111111111111111111111111111
   10010000010000011000000000000000000000000000001
   11000001111110001000000000000000000000001111001
   10000000001000100001111000000000000000000000001
   1001010010100000001    10N00100000000000000001
   10000000000000000001111001000000000000000000001
   10000100000000000011100000000000000000000000001
   10000000000000000001000000000000000000000000011
   11111100000001110000000000000000000000000001111
   10000001111000000000011111000000000000000000001
    111111111111111111111111111111111111111111111
    
1                                                    1